NO ./textures/north.xpm
SO ./textures/south.xpm
WE ./textures/west.xpm
EA ./textures/east.xpm
F 20,100,0
C 225,30,0

       111111111111111111
1111111100000000000000001
10000000000000011100000001111111
1000000001111100000001N00000001
11111111111111111100000111000001
11111111111111111111111111000001
11111111 111111111111111 1111111