NO ./textures/north.xpm
SO ./textures/south.xpm
WE ./textures/west.xpm
EA ./textures/east.xpm
F 220,100,0
C 225,30,0

11111111111
1N00000000011111111
1110000000000000001
1111111111111111111
1
1
1
11
1
1
1
1
11
