NO ./textures/cobblestone.xpm
SO ./textures/cobblestone_01.xpm
WE ./textures/mossy_cobblestone1.xpm
EA ./textures/cobblestone_02.xpm

C 255,99,99
F 76,76,76

1111111111111111111
10010S0001001000001
1011001001001000001
101100001000001001
1001001001111101111
1001001001111101111
1001111000001001001
1001111000001001001
1000000000000001001
1000000000000001001
1001111111111001001
1001111111111001001
1111000000000001011
1111000000000001011
1000000001000000001
1000000001000000001
1111111111111111111
