NO ./textures/north.xpm
EA ./textures/east.xpm
SO ./textures/south.xpm
WE ./textures/west.xpm
F 102,96,88
C 110,135,155

111111111111111111111
110000010000001000011
111101011111110101101
100001010000010100001
101111011011110111101
101000010010000100101
101011110010111101101
101000000000000001101
101111111011111111101
100000001010000000001
111111101010111111101
100000101000100000001
101110101111101011101
10100010000000100010111111111111111111111111111
101011111011111110100000000000000000000000000E01
10000000001000000000111111111111111111111111111
111111111111111111111
