NO ./textures/north.xpm
SO ./textures/south.xpm
WE ./textures/west.xpm
EA ./textures/east.xpm
F 102,96,88
C 110,135,155

111111111111111111111
1N0000010000001000011
111101011111110101101
100001010000010100001
101111011011110111101
101000010010000100101
101011110010111101101
101000000000000001101
101111111011111111101
100000001010000000001
111111101010111111101
100000101000100000001
101110101111101011101
101000100000001000101
101011111011111110101
100000000010000000001
111111111111111111111
