NO ./textures/north.xpm
SO ./textures/south.xpm
WE ./textures/west.xpm
EA ./textures/east.xpm
F 25,120,25
C 135,206,235

1111111111111111111111111
10000011111111111111111111111111111111111
1000000000000000000000000000000000000000011
10000000000000000000S00000000000000000000001
11111111111111111111111111111111111111111111