NO ./textures/north.xpm
EA ./textures/east.xpm
SO ./textures/south.xpm
WE ./textures/west.xpm
F 102,96,88
C 110,135,15

       111111111111111111111
      101000001000000000001
11111110101111111000111111
100010100010000010001
111110101111101011101
1000001010 0101000001
101111101011101111111
101000001010100000101
101011111010111110101
110101000101010001011
101110101110101010101
100000101 10001010001
111111101111111011101
100000101000100010001
101110101110101110111
101000100000100010101
101011111111111010101
100010000000000010001
101010111011111111101
1N1000001000000000001
111111111111111111111